NO        /texture/wall/wall_no.xpm
SO                          /texture/wall/wall_so.xpm
WE          /texture/wall/wall_we.xpm 
EA   /texture/wall/wall_ea.xpm

F 188   ,     186,   181
C           64,          80,      181

11111111111111111   11111
10000000000000001   10S01
10000000000000001   10001
1000000000000000111111D11
1000000000000000010000001
10000000000000000D0000001
1000000000000000010000001
111111111111111111111D111
1000000000000000010000001
10000000000000000D0000001
1000000000000000010000001
10000011111111111111D1111
1000001     1   100000001
1000001     1   100000001
11111D111111111111111D111
1000000000001000000000001
1000000000001000000000001
1000000000001000000000001
100000000000D000000000001
1000000000001000000000001
11111111D11111111111111111111111
1      10000000000000000000D00B1
111111111111111D1111111111111111
1000001000000000000000001   1
1000001000000000000000001   1
11111111111111111111111111111
