NO        /texture/wall/wall_no.xpm
SO                          /texture/wall/wall_so.xpm
WE          /texture/wall/wall_we.xpm 
EA   /texture/wall/wall_ea.xpm

F 188   ,     186,   181
C           64,          80,      181

1111111111111111111111111111111111
1000000000000000000000000000000001
10000000000000000S0000000000000001
1000000000000000000000000000000001
1000000000000000000000000000000001
1000000000000000000000000000000001
1000000000000000000000000000000001
1000000000000000000000000000000001
1000000000000000000000000000000001
1000000000000000000000000000000001
1000000000000000000000000000000001
1000000000000000000000000000000001
1000000000000000000000000000000001
1000000000000000000000000000000001
1000000000000000000000000000000001
1111100000000000000000000000000001
1000D00000000000000000000000000001
1000100000000000000000000000000001
1000100000000000000000000000000001
1111111111111000000001111111111111
1           1000000001           1
1           1000000001           1
1           1000000001           1
1           10000B0001           1
1111111111111111111111111111111111
