NO        /texture/wall/wall_no.xpm
SO                          /texture/wall/wall_so.xpm
WE          /texture/wall/wall_we.xpm 
EA   /texture/wall/wall_ea.xpm

F 188   ,     186,   181
C           64,          80,      181

1111111111111111111111111
1000000000000000111110001
1000000000000000111110S01
1000000000000000111111011
1000000000000000010000001
10000000000000000D0000001
1000000000000000010000001
1111111111111111111110111
1000000000000000010000001
10000000000000000D0000001
1000000000000000010000001
1000001111111111111101111
1000001         100000001
1000001         100000001
1111101111111111111110111
1000000000001000000000001
1000000000001000000000001
1000000000001000000000001
100000000000D000000000001
1000000000001000000000001
11111111D111111111111111111111111111
110000000000000000000000000000D00B01
111111111111111D11111111111111111111
1000001000000000000000001   1
1000001000000000000000001   1
11111111111111111111111111111
