SO /texture/wall/wall_so.xpm
WE                       /texture/wall/wall_we.xpm


C      0,     128, 255

EA   			/texture/wall/wall_ea.xp

F  128 , 128,  2555

N                                  /texture/wall/wall_no.xpm

1111110111111111111111111
100D000000110000000000000
1011000001110000000000001
100100000000000000000000111111111
111111111D11000001110000D00000001
10000000001100000111D111100011111
11110111111111011100000010001
1111D111111111011101010010001
11000000110101D11100000010001
10000000000000001100000010001
10E00000000000001101010010001
1100000111010101111101111000111
11110111 1110101 101111010B01
11111111 1111111 111111111011
