NO        /texture/wall/wall_no.xpm
SO /texture/wall/wall_so.xpm
WE          /texture/wall/wall_we.xpm 
EA   /texture/wall/wall_ea.xpm

F  128 , 128,  128
            C      0,     128, 255

1111111111111
1000000000D01
10000000001B1
1D11111111111
1000000000001
1000000000001
1000000000001
1000000000001
100000N000001
1111111111111
