NO        /texture/wall/wall_no.xpm
SO /texture/wall/wall_so.xpm
WE          /texture/wall/wall_we.xpm 
EA   /texture/wall/wall_ea.xpm

F  128 , 128,  128
            C      0,     128, 255

111111111111111
100000000000001
1000000S0000001
100000000000001
100000000000001
1D1111000010001
100001000000001
100001000000001
1B0001000000001
111111111111111
