NO        ./path_to_the_north_texture
SO ./path_to_the_south_texture
WE          ./path_to_the_west_texture 
EA   ./path_to_the_east_texture

F  255 , 100,  255
            C      255,     30, 0

1111111111111
1000000000001
1000011100001
1000000000001
100000N000001
1111111111111
