NO        /texture/wall/wall_no.xpm
SO /texture/wall/wall_so.xpm
WE          /texture/wall/wall_we.xpm 
EA   /texture/wall/wall_ea.xpm

F  128 , 128,  128
            C      0,     128, 255

1111111111111
1000000000001
10000000000B1
1011111000011
1000001000001
1000001000001
1010001000011
1010000000001
1B10000000N01
1111111111111
